0000000000000000000000000000000000000000000000000000000000000000
0000000000000000000000000000000000000000000000000000000000000000
0000000000000000000000000000000000000000000000000000000000000000
0000000000000000000000000000000000000000000000000000000000000000
0000000000000000000000000000000000000000000000000000000000000000
0000000000000000000000000000000000000000000000000000000000000000
0000000000000000000000000000000000000000000000000000000000000000
0000000000000000000000000000000000000000000000000000000000000000
0000000000000000000000000000000000000000000000000000000000000000
0000000000000000000000000000000000000000000000000000000000000000
0000000000000000000000000000000000000000000000000000000000000000
0000000000000000001111111111111111111111111000000000000000000000
0000000000000000001222222222222222222222221000000000000000000000
0000000000000000001233333333333333333333321000000000000000000000
0000000000000000001233333333333333333333321000000000000000000000
0000000000000000001233333333333333333333321000000000000000000000
0000000000000000001233333333333333333333321000000000000000000000
0000000000000000001233333333333333333333321000000000000000000000
0000000000000000001233333333333333333333321000000000000000000000
0000000000000000001233333333333333333333321000000000000000000000
0000000000000000001233333333333333333333321000000000000000000000
0000000000000000001233333333333333333333321000000000000000000000
0000000000000000001233333333333333333333321000000000000000000000
0000000000000000001233333333344433333333321000000000000000000000
0000000000000000001233333333344433333333321000000000000000000000
0000000000000000001233333333344433333333321000000000000000000000
0000000000000000001233333333333333333333321000000000000000000000
0000000000000000001233333333333333333333321000000000000000000000
0000000000000000001233333333333333333333321000000000000000000000
0000000000000000001233333333333333333333321000000000000000000000
0000000000000000001233333333333333333333321000000000000000000000
0000000000000000001233333333333333333333321000000000000000000000
0000000000000000001233333333333333333333321000000000000000000000
0000000000000000001233333333333333333333321000000000000000000000
0000000000000000001233333333333333333333321000000000000000000000
0000000000000000001222222222222222222222221000000000000000000000
0000000000000000001111111111111111111111111000000000000000000000
0000000000000000000000000000000000000000000000000000000000000000
0000000000000000000000000000000000000000000000000000000000000000
0000000000000000000000000000000000000000000000000000000000000000
0000000000000000000000000000000000000000000000000000000000000000
0000000000000000000000000000000000000000000000000000000000000000
0000000000000000000000000000000000000000000000000000000000000000
0000000000000000000000000000000000000000000000000000000000000000
0000000000000000000000000000000000000000000000000000000000000000
0000000000000000000000000000000000000000000000000000000000000000
0000000000000000000000000000000000000000000000000000000000000000
0000000000000000000000000000000000000000000000000000000000000000
0000000000000000000000000000000000000000000000000000000000000000
0000000000000000000000000000000000000000000000000000000000000000
0000000000000000000000000000000000000000000000000000000000000000
0000000000000000000000000000000000000000000000000000000000000000
0000000000000000000000000000000000000000000000000000000000000000
0000000000000000000000000000000000000000000000000000000000000000
0000000000000000000000000000000000000000000000000000000000000000
0000000000000000000000000000000000000000000000000000000000000000
0000000000000000000000000000000000000000000000000000000000000000
0000000000000000000000000000000000000000000000000000000000000000
0000000000000000000000000000000000000000000000000000000000000000
0000000000000000000000000000000000000000000000000000000000000000
0000000000000000000000000000000000000000000000000000000000000000
0000000000000000000000000000000000000000000000000000000000000000
0000000000000000000000000000000000000000000000000000000000000000
0000000000000000000000000000000000000000000000000000000000000000
